CONTIG	POSITION	REF_COUNT	ALT_COUNT	REF_NUCLEOTIDE	ALT_NUCLEOTIDE	READ_DEPTH	HET_LOG_ODDS
1	881627	31	31	G	A	62	233.4706
1	943468	19	20	T	C	39	135.8794
1	949235	23	25	G	A	48	177.8977
1	949608	45	57	G	A	102	377.2653
1	949654	65	48	A	G	113	395.5153
1	1153113	42	40	G	A	82	269.5817
1	1479333	54	52	A	G	106	395.5530
1	1551927	16	19	T	C	35	110.7288
1	1581713	22	22	A	C	44	175.0504
1	1635565	16	14	C	T	30	97.7232
1	1647686	21	12	A	C	33	96.6374
1	1650807	193	90	T	C	283	668.3633
1	1650845	244	123	G	A	367	817.9260
1	1684169	13	9	C	G	22	74.7058
1	1686962	48	48	C	T	96	329.8645
1	1696659	102	107	A	G	209	736.7514
1	1847979	27	20	T	C	47	158.1021
1	1848160	189	176	A	G	365	1329.1709
1	1849529	82	70	A	G	152	528.7884
1	1849530	70	80	T	C	150	481.6940
1	1849744	49	47	G	A	96	311.5358
1	1853863	24	25	T	C	49	171.7360
1	1854546	31	36	C	T	67	260.3748
1	1855319	44	59	C	T	103	342.1627
1	1916890	104	90	C	T	194	599.5486
1	1918488	51	47	A	G	98	349.0661
1	1918535	20	18	A	T	38	128.3391
1	1957037	68	76	T	C	144	436.9231
1	1987993	43	45	T	C	88	302.5523
1	1991014	40	22	A	G	62	152.0079
1	1991123	10	12	G	A	22	82.2707
2	224919	140	115	A	G	255	941.8416
2	224970	71	45	C	T	116	286.0343
2	230912	15	20	A	C	35	108.4742
2	271797	79	53	G	A	132	385.4378
2	272203	36	39	C	T	75	269.4166
2	277003	60	50	A	G	110	367.2354
2	1079130	19	15	G	A	34	104.1016
2	1079132	19	16	G	A	35	112.5706
2	1168756	98	111	G	A	209	788.7738
2	1168982	11	13	T	A	24	86.1417
2	1426787	25	23	G	A	48	157.9784
2	1437163	26	25	A	C	51	192.5709
2	1497803	50	34	C	T	84	227.5308
2	1499728	10	11	C	T	21	75.3409
2	1499899	46	29	C	T	75	208.0020
2	1499927	47	27	A	C	74	219.9737
2	1520676	92	66	T	C	158	478.1458
2	1651842	32	24	C	A	56	174.9226
2	1652660	16	15	G	A	31	97.6653
2	1664654	48	47	A	G	96	328.7426
2	1667310	42	51	G	A	93	283.9489
2	1983374	24	24	A	C	48	165.5205
10	329188	79	61	G	T	140	374.4491
10	412449	9	9	A	G	18	70.8207
10	435880	46	48	G	C	94	367.1189
10	436848	60	53	A	G	113	382.6132
10	444997	10	17	C	T	27	74.1959
10	459940	46	54	G	A	100	380.9182
10	1046712	116	105	G	A	221	750.6177
10	1070461	25	32	C	T	57	201.5169
10	1088746	25	37	T	G	62	161.9863
10	1279503	18	25	G	T	43	119.8031
10	1279598	103	84	G	A	187	580.3082
10	3124516	17	23	G	A	40	139.3683
10	3145885	19	14	T	C	33	108.5014
10	3145906	22	23	A	C	45	149.9911
10	3146155	15	13	C	G	28	105.3412
10	3147501	26	52	C	T	78	192.2348
10	3147518	67	32	G	C	99	243.8372
10	3147519	66	34	G	C	100	263.2852
10	3149402	44	30	A	G	74	210.2511
10	3150898	106	92	C	T	198	645.0096
10	3154339	13	13	C	T	26	95.0060
10	3155285	11	13	G	A	24	78.7834
10	3155353	15	14	C	T	29	91.2746
10	3155620	32	21	A	G	53	144.9182
10	3155698	23	18	C	T	41	127.6478
10	3160913	13	17	G	A	30	87.1861
10	3171857	15	19	T	C	34	110.3122
10	3172121	51	48	C	T	99	334.7320
10	3172145	37	41	C	T	78	260.0462
10	3175360	87	72	C	G	159	619.5454
10	3175541	40	32	C	A	72	212.2403
10	3177878	11	10	C	T	21	69.1786
10	3178076	18	16	A	T	34	116.7123
10	3178814	15	23	T	A	38	105.7065
10	3180951	22	26	G	A	48	185.8979
10	3207632	15	17	A	G	32	112.3920
10	5346772	13	12	G	A	25	84.4833
10	5415954	21	11	A	G	32	74.8420
10	5435918	71	62	G	A	133	466.2188
10	5498248	10	15	G	T	25	80.1933
10	5541181	56	38	T	C	94	297.8485
10	5541183	58	39	C	T	97	258.5527
10	5541230	79	65	T	C	144	480.2785
10	5682855	31	37	T	C	68	215.5211
10	5682856	31	36	G	C	67	247.1974
10	5818268	12	11	T	C	23	83.5702
10	5919947	50	34	C	T	84	223.8448
10	5920121	217	213	T	C	430	1565.5874
10	5924942	16	23	C	G	39	122.8803
10	5951025	97	94	T	C	191	754.4769
10	5978411	64	42	T	C	106	349.0791
10	5998285	10	15	G	A	25	80.8794
10	6002368	157	127	T	G	284	982.9460
10	6255817	15	21	T	C	36	105.0244
10	6268422	14	11	A	G	25	88.8927
10	6472891	48	31	G	T	79	216.1798
10	6498723	66	53	G	A	119	372.6250
10	6504126	14	21	T	C	35	90.5740
10	6504136	17	20	C	G	37	138.9361
10	6521147	31	38	G	A	69	255.0186
10	6533625	61	48	T	A	109	336.5353
10	6533877	29	23	A	G	52	188.0642
10	6533900	18	15	C	T	33	104.5647
10	6556854	15	16	C	T	31	112.3471
10	7318803	39	38	T	C	77	274.2447
10	7615195	23	26	C	A	49	183.3732
10	7618501	31	33	A	G	64	209.3270
10	7618686	30	41	T	G	71	190.2471
10	7618993	33	26	G	A	59	194.1482
10	7618997	29	23	G	A	52	173.8324
10	7621578	9	9	C	A	18	71.9855
10	7679393	72	56	C	T	129	414.2779
10	7682870	51	70	C	G	121	440.7599
10	7759595	181	197	C	T	378	1381.3387
10	7759865	14	16	A	G	30	93.1184
10	7769101	20	17	T	G	37	141.4697
10	7776831	44	55	C	T	99	326.3503
10	7798150	12	11	C	T	23	82.4672
10	7808086	39	49	T	C	88	294.2014
10	7811407	15	22	G	C	37	114.6438
10	7816662	15	11	G	A	26	75.7958
10	7829759	80	50	C	T	130	315.2073
10	7830064	11	12	A	T	23	78.3190
10	7838208	11	10	A	G	21	77.6367
10	7838932	13	11	C	T	24	77.4031
10	7844195	26	25	C	T	51	195.5926
10	7849054	15	11	G	T	26	72.7980
10	7849688	53	54	T	C	107	388.2306
10	7866557	60	72	T	C	132	453.4319
10	7866576	42	40	A	T	82	297.3244
10	8006798	81	85	A	G	166	579.5668
10	8007559	54	38	G	C	92	300.3772
10	8007560	53	39	T	C	92	262.6846
10	8203302	37	44	T	C	81	257.3027
10	8556719	49	32	G	A	81	239.5712
10	11299735	42	43	A	T	85	284.1993
10	11316987	98	105	G	A	203	683.8228
10	11355993	25	33	G	A	58	205.3760
10	11356160	52	45	C	T	97	310.9532
10	11805204	18	12	A	C	30	93.8888
10	11805249	26	30	T	C	56	173.9135
10	11805339	36	38	C	T	74	263.8252
10	11978499	50	43	T	G	93	335.5439
10	12123666	19	18	C	T	37	108.0736
10	12126490	21	23	A	T	44	141.5249
10	12131081	110	101	T	G	211	741.6491
10	12160632	23	25	T	C	48	160.0510
10	12288302	72	42	A	G	114	334.6247
10	12292286	33	25	C	G	58	212.7348
10	12292344	42	31	A	G	73	250.3911
10	12595147	84	70	C	T	154	499.1705
10	12867598	113	80	C	G	193	657.5016
10	13100269	65	86	C	A	151	543.5821
10	13146634	30	30	T	C	60	218.5841
10	13151224	104	111	G	A	215	743.2828
10	13151354	22	22	A	G	44	148.1436
10	13178697	25	23	C	A	48	178.2146
10	13199611	14	12	C	T	26	86.0882
10	13275676	58	52	T	C	110	370.0969
10	13275691	60	58	G	T	118	406.2612
10	13320236	17	16	C	T	33	109.1218
10	13330291	19	23	G	T	42	163.3163
10	13330402	53	34	T	C	87	241.7272
10	13534554	66	59	T	C	125	465.8515
10	13534851	71	73	A	G	144	535.2468
10	13633835	38	22	A	G	60	174.9322
10	13633929	37	21	T	G	58	150.1938
10	13658335	33	29	G	A	62	221.3698
10	13693883	40	32	C	T	72	212.0074
10	13743517	45	51	G	A	96	355.2903
10	13782110	30	34	A	C	64	210.7435
10	13838604	45	54	A	G	99	306.3356
10	13900693	13	15	C	A	28	104.4282
10	14478618	14	9	T	C	23	73.5438
10	14976414	108	34	G	A	142	202.5055
10	15106441	67	41	A	G	108	351.3795
10	15256194	80	65	G	A	145	450.8818
10	15262784	16	16	A	G	32	110.1571
10	15263100	31	24	C	T	55	169.1943
10	15701093	14	24	A	G	38	91.0268
10	16526840	32	16	G	A	48	102.4080
10	16547058	112	75	A	G	187	632.9032
10	16556710	34	33	T	C	67	232.9071
10	16911605	116	90	C	A	206	670.1290
10	16948177	31	31	A	G	62	238.3006
10	16949401	10	13	G	A	23	85.0021
10	16949447	22	18	A	C	40	138.4337
10	16967445	17	9	T	G	26	70.8059
10	16979661	53	33	T	C	87	247.0754
10	17196670	40	48	T	C	88	268.6393
10	17199778	30	27	C	A	57	192.9649
10	17199830	13	17	A	C	30	88.5647
10	17201247	30	45	A	G	75	226.3469
10	17204139	140	107	G	A	247	779.6181
10	17204258	41	49	A	C	90	287.4569
10	17210881	28	21	A	G	49	169.7523
10	17362784	18	10	A	G	28	85.4416
10	17364962	17	11	A	G	28	90.9224
10	17365012	27	31	T	A	58	185.3776
10	17365013	28	32	T	A	60	199.8144
10	17365044	53	46	T	G	99	376.3578
10	17365169	68	47	A	G	115	382.2526
10	17373617	11	12	G	A	23	89.0935
10	17636182	71	38	G	C	109	292.9971
10	17636309	68	63	G	A	131	417.6509
10	17702640	9	15	C	T	24	75.6163
10	17747812	48	41	A	G	89	331.8003
10	17875857	18	13	T	G	31	111.5241
10	17891705	115	84	A	G	199	578.9058
10	18242311	70	47	A	G	117	373.4742
10	18254354	22	17	T	C	39	139.8319
10	18254655	19	12	C	T	31	76.4149
10	18266989	65	82	G	A	147	529.1764
10	18267096	18	12	G	A	30	81.0236
10	18270422	29	27	G	A	56	209.9778
10	18276682	20	20	G	C	40	172.3532
10	18789724	38	35	T	G	73	284.1911
10	18823279	19	12	T	A	31	89.5270
10	18840919	43	39	T	A	82	271.4722
10	18884992	13	10	T	C	23	77.9019
10	18931512	64	66	T	C	130	422.2004
10	18940157	64	57	C	A	121	402.3292
10	18957647	45	25	T	G	70	200.5599
