CONTIG	POSITION	REF_COUNT	ALT_COUNT	REF_NUCLEOTIDE	ALT_NUCLEOTIDE	READ_DEPTH	HET_LOG_ODDS
1	909073	19	18	C	T	37	137.0784
1	909238	19	13	G	C	32	101.4312
1	985266	21	15	C	T	36	103.4082
1	1249187	76	58	G	A	134	391.2095
1	1333598	66	89	C	A	155	523.8586
1	1337334	17	18	G	T	35	130.6483
1	1387726	26	17	A	G	43	107.2049
1	1387764	35	24	G	A	59	160.1969
1	1392451	19	16	C	T	35	115.5566
1	1421531	40	23	C	A	63	150.3495
1	1423267	34	23	A	G	57	150.3591
1	1425700	20	29	T	C	49	128.9044
1	1479333	33	31	A	G	64	226.7929
1	1582202	19	17	C	T	36	116.6585
1	1586752	12	13	T	C	25	80.5732
1	1636274	12	15	C	T	27	96.4315
1	1647928	22	15	A	G	37	117.6518
1	1650807	81	168	T	C	249	527.1465
1	1650845	97	229	G	A	326	652.8251
1	1895177	44	24	C	T	68	165.4645
1	1896440	13	12	G	A	25	89.5465
1	1900232	51	43	T	C	94	295.1637
1	1916890	62	42	C	T	104	257.6776
1	1918488	32	34	A	G	66	211.1005
1	1922303	33	35	C	T	68	254.7238
1	1957037	54	51	T	C	105	365.0214
1	1961408	22	28	C	T	50	160.7589
2	224919	117	118	A	G	235	754.5603
2	230912	25	27	A	C	52	182.7205
2	234130	75	65	T	G	140	547.7379
2	271797	45	41	G	A	86	311.6104
2	272203	32	36	C	T	68	244.9599
2	276942	29	29	A	G	58	197.7593
2	277003	70	69	A	G	139	485.0804
2	1079130	18	17	G	A	35	120.3385
2	1079132	20	16	G	A	36	107.2794
2	1079442	14	16	G	A	30	109.5869
2	1426796	22	17	G	C	39	138.7000
2	1437163	31	27	A	C	58	215.0064
2	1460004	58	46	G	T	104	309.4811
2	1488668	31	32	T	C	63	217.8334
2	1499899	38	17	C	T	55	106.4820
2	1499927	40	21	A	C	61	156.3932
2	1520676	48	42	T	C	90	305.0970
2	1664654	35	29	A	G	64	198.3526
2	1667267	12	18	C	G	30	94.1145
2	1667310	31	43	G	A	74	203.0922
10	131636	18	11	T	C	29	75.3086
10	294165	50	39	T	C	89	320.1464
10	323283	52	42	A	G	94	291.5345
10	329487	21	18	A	G	39	148.3229
10	329493	20	17	C	A	37	129.9955
10	429977	18	27	G	A	45	113.1337
10	435880	24	25	G	C	49	193.0699
10	436547	12	19	G	A	31	75.7327
10	436848	33	33	A	G	66	198.5947
10	444997	10	22	C	T	32	70.5236
10	459940	23	25	G	A	48	180.8170
10	859270	11	11	C	T	22	86.6093
10	910225	28	25	A	G	53	200.0250
10	1126293	15	11	T	C	26	89.8045
10	1230968	14	14	C	T	28	92.8891
10	1232500	16	21	G	A	37	119.9069
10	1279598	82	66	G	A	148	450.1323
10	1779349	20	25	G	A	45	150.2866
